################################################################
........#...................#..................................#
........#...................#....................##............#
........#...############....#..................................#
........#...#..........##...#...O..............................#
........#...#...........##..###################......#.........#
........#...#............#..........................##.........#
........#...#............#.........................##..........#
........#...#............########....##..##.##...###...........#
........#...#..................................................#
........#...#..................................................#
............#..................................................#
............#..................................................#
#############..................................................#
................................................................
................................................................
................................................................
................................................................
................................................................
................................................................
................................................................
................................................................
................................................................
................................................................
................................................................
................................................................
................................................................
................................................................
................................................................
................................................................
................................................................
----------------------------------------------------------------