...........####################................................#
...........#O.................#................................#
...........#######......#######................................#
#####................................#####.....................#
#...#....................................#.....................#
#...#......####.....##.....####..........#.....................#
#...#................................#...#.....................#
#...#................................#...#.....................#
#...#........#...#......#...#........#...#.....................#
#...#................................#...#.....................#
#....................................#...#.....................#
#................########............#...#.....................#
#................#......#............#...#.....................#
##################......########################################
................................................................
................................................................
................................................................
................................................................
................................................................
................................................................
................................................................
................................................................
................................................................
................................................................
................................................................
................................................................
................................................................
................................................................
................................................................
................................................................
................................................................
----------------------------------------------------------------