...............................................................#
...............................................................#
...............................................................#
...............................................................#
...............................................................#
...............................................................#
...............................................................#
.............#....................#............................#
.............#....................#............................#
.............#........##########..#.......####.................#
.............#....................#......#....#................#
.............#....................#.....#......#...............#
.............#....................#....#........#..........O...#
##############....................##############################
................................................................
................................................................
................................................................
................................................................
................................................................
................................................................
................................................................
................................................................
................................................................
................................................................
................................................................
................................................................
................................................................
................................................................
................................................................
................................................................
................................................................
----------------------------------------------------------------